1,6,4 2,6,1 2,7,1 2,8,1 2,5,2 2,5,3 2,9,2 2,9,3 2,10,4 2,11,4 2,4,4 2,3,4 2,2,5 2,2,6 2,2,7 2,3,7 2,4,7 2,5,7 2,6,7 2,7,7 2,8,7 2,9,7 2,10,7 2,11,7 2,12,7 2,12,6 2,12,5 3,4,5 3,6,5 3,10,5 4,6,2 4,7,2 4,8,2
1,2,5 2,3,1 2,4,1 2,5,1 2,6,1 2,7,1 2,8,1 2,9,1 2,10,1 2,11,1 2,3,2 4,7,2 2,12,2 2,2,3 2,3,3 3,5,3 2,7,3 3,9,3 2,12,3 2,1,4 4,4,4 3,7,4 4,10,4 2,12,4 2,1,5 2,12,5 2,1,6 2,2,6 2,3,6 2,4,6 2,5,6 2,6,6 2,7,6 2,8,6 2,9,6 2,10,6 2,11,6 2,12,6
1,9,3 2,2,1 2,3,1 2,4,1 2,5,1 2,6,1 2,7,1 2,8,1 2,9,1 2,10,1 2,11,1 2,12,1 2,2,2 4,3,2 2,4,2 2,5,2 2,9,2 2,12,2 2,1,3 2,2,3 3,5,3 3,8,3 3,10,3 2,12,3 2,1,4 3,5,4 4,7,4 2,8,4 2,9,4 2,10,4 4,11,4 2,12,4 2,1,5 2,7,5 2,8,5 2,10,5 4,11,5 2,12,5 2,1,6 2,2,6 2,3,6 2,4,6 2,5,6 2,6,6 2,7,6 2,10,6 2,11,6 2,12,6
1,6,3 2,1,1 2,2,1 2,3,1 2,4,1 2,5,1 2,6,1 2,7,1 2,8,1 2,9,1 2,10,1 2,11,1 2,12,1 2,1,2 2,7,2 4,8,2 4,11,2 2,12,2 2,1,3 3,5,3 2,7,3 2,9,3 2,11,3 2,12,3 2,1,4 3,3,4 2,4,4 2,5,4 2,6,4 2,7,4 2,12,4 2,1,5 2,4,5 4,5,5 3,8,5 2,12,5 2,1,6 3,3,6 3,5,6 2,7,6 2,8,6 2,9,6 2,12,6 2,1,7 2,7,7 2,8,7 4,9,7 4,10,7 2,12,7 2,1,8 2,2,8 2,3,8 2,4,8 2,5,8 2,6,8 2,7,8 2,8,8 2,9,8 2,10,8 2,11,8 2,12,8
1,8,4 2,2,1 2,3,1 2,4,1 2,5,1 2,6,1 2,7,1 2,8,1 2,2,2 2,8,2 2,9,2 2,1,3 3,4,3 4,8,3 2,9,3 2,1,4 2,4,4 2,5,4 3,7,4 2,9,4 2,10,4 2,11,4 2,12,4 2,1,5 2,4,5 2,5,5 2,6,5 2,7,5 3,8,5 4,10,5 4,11,5 2,12,5 2,1,6 3,3,6 3,4,6 2,6,6 2,10,6 2,11,6 2,12,6 2,1,7 2,6,7 4,10,7 4,11,7 2,12,7 2,1,8 2,2,8 2,3,8 2,4,8 2,5,8 2,6,8 2,7,8 2,8,8 2,9,8 2,10,8 2,11,8 2,12,8