p#############
 #s#s#s#     #
 # # # # bbb #
             #
#s b      b s#
##############
*
##############
#ss#ss#      #
#     b b    #
#bb#  # ######
#  #  # #
#p      #
#########
*
##############
#s s##      s#
#   b   b#####
# b #    #####
#   #  p     #
#            #
#####  b  b  #
    #s      s#
    ##########
*

